R 1270 720


SO ./textures/catacomb/3.xpm
NO ./textures/catacomb/d_2.xpm
WE ./textures/catacomb/4.xpm
EA ./textures/catacomb/d_1.xpm

S ./textures/catacomb/shar.xpm


F 51,51,51
C 0,5,25

                            111111111111111
                            111111111111111
     111111                 120000000002111111
     100001      11111111111100200000200111111
     100001      10000000000100000000000122211
     1000001     10000000000000000000002002211
     1000101     10000000000100000000000122211
     11201011111 10001111111100000000000111111
     10000022001 10001      100000000000111111
     1020002022111000111    11111101111111
     1002000000100020001    11111000111111
     1000020200000020001      111020111111
1111 1000000000100000201      11102011
1111 12220000201111111111     11100011
1022112200000021          11111110001111
1020111111011111          11111110001111
10001   10001             11000200200211
1101    10201             11201110001111
1000111110001             11001110001111
1020100210001             11001110001111
1000000010201             111111102011             1111111111111
1000100210201             1111111000111111111      1111111111111
1000111111011111                1101100000001      1111111111111
1020110000000001          11111120002111011011111111112000222211
1000110000000201          12020000000000021000000000010000000211
1000110020002001         120000000000000002111101110010000020011
1000010000000001          10000000000000000000000000010000000011
1020000200200001          12020000200022000000000000000000002001
1000010000000001          10000000000000000100000000002000000011
10001100200020011        120000000000000002111000001112022020211
1000110200000201         112000000000000021001100111102000000011
1000110000000201         111210100000112101011000011010000002011
1020112111011111            1 1111011100000011000110000120120101
1000011110001                  110000111111111100010001000000001
10001111000001                 1000001       1000110000000000001
1000120210001                  1100001       110201111111111111
1000002010201                  1000011       10001100100000101
10001200200001   1             1000001       11000100202220011
10201111100001111011111 1      1100011       11000002020002201
10200111002010100110120101     100001        10020100220020211
100000000000000001000002101    1100001       11011100101010101
1020002000200020000002000001   1000001       11111111111111111
100000000000000001000002101    1000011
100100100111110111101210111 111110200111111
1111111111010010010211111  1101011011111011
        1002001001001     10220010031000001
         101000001111     11000003003020001
          1 10111         11000010031000001
            1001          10000030003000001
            1021          11111110011111111
            1111          11001140041100011
                          10000000000000201
                          11000000000000011
                          11111100000110111
                          11000000000000011
                          10000000000020011
                          11200000N00000011
                          11111111111111111
