R 1270 720

SO ./textures/catacomb/3.xpm
NO ./textures/catacomb/d_2.xpm
WE ./textures/catacomb/4.xpm
EA ./textures/catacomb/d_1.xpm

S  ./textures/catacomb/shar.xpm

C 76,252,252
F 0,167,33

   111 1111
   1001 1001    1111
   100111001    10001
 11100000001111110011
 10000000000000000011
 10002000000000200001
 10000000000000000011
 10000000000001111111
 10011100020001
 1111 100000001
      100000001 11111
111111100020001 10001
100002000000001 10201
100000000000001 10001
100111111100001 10001
1001     100001 10001
1021111  100001110001
1000001  1000000000011
1020001  100002000001
1000001  100000000001
1112111  11111111111
1110111111
100N000001
111111111
