1111111111111111111111111
1000000000000000000000001
1000000000000000000000001
1001100110000000110011001
1001100110000000110011001
1001100110000000110011001
1001100110010100110011001
1001100110010100110011001
1001100110011100110011001
1000000000000000000000001
1000000000000000000000001
1110011110000000111100111
111001111000N000111100111
1000000000000000000000001
1000000000000000000000001
1001100110000000110011001
1001100110000000110011001
1001100110010100110011001
1001100110010100110011001
1001100110011100110011001
1001100110000000110011001
1001100110000000110011001
1000000000000000000000001
1000000000000000000000001
1111111111111111111111111
